ZZZZZZZZZZZZZZZZZZZ
Z#...#.##.########Z
Z#.S.#.....N....K.Z
Z#...#..#.....####Z
Z#...#..#.....N..#Z
Z....#..#......#.#Z
Z#......#..N...#.#Z
Z..............#C#Z
Z..###########....Z
ZZZZZZZZZZZZZZZZZZZ